WWWWWWWWWWWWWWWWWWWWWWWWWWWWWWWWWWWWWWWWWWWWWWWW
WWWWWWWWWWWWWWWWWWWWWWWWWWWWWWWWWWWWWWWWWWWWWWWW
WW                                            WW
WW  WWWWWWWWWWWWWWWWWWWWWWWWWWWWWWWWW         WW
WW    WW              WW                      WW
WWWWWWWWWWWWWW        WW     WW       WW      WW
WW                    WW     WW       WW      WW
WW     WWWWWWWWWWWWWWWWW     WW       WW      WW
WW     WW                    WW       WW      WW
WW     WW   WWWWWWWWWWWW     WW    WWWW       WW
WW     WW   WW               WW     WW        WW
WW     WWWWWWW               WW     WW        WW
WW     WW        WWWW        WW     WW        WW
WW     WW       WW  WW       WW     WW        WW
WW    WW      WW    WW              WW        WW
WW    WW      WW     WWWWWWWWWW     WW        WW
WW    WW      WW            WW      WW        WW
WW            WW     WWWWWWWW       WW        WW
WW    WWWWWWWWWW                    WW        WW
WWWWWWWWWWWWWWWWWWWWWWWWWWWWWWWWWWWWWWWWWWWWWWWW
WWWWWWWWWWWWWWWWWWWWWWWWWWWWWWWWWWWWWWWWWWWWWWWW